12 12 12 12 12 12 12 12 12 12 12 12 12 12 12 12 12 12 12 12 12 12 12 12 12 12 12 12 12 12 12 12 12 12 12 12 12 12 12 12 12 12 12 12 12 12 12 12 12 12 12 12 12 12 12 12 12 12 12 18 18 18 18 18 18 18 18 18 18 18 18 18 18 18 18 18 18 18 18 18 18 18 18 18 18 18 18 18 18 18 18 18 18 18 18 18 18 18 18 18
18 18 19 18 18 18 18 18 18 18 18 18 18 18 18 18 18 18 18 18 18 18 18 19 18 18 18 18 18 18 18 18 18 18 18 18 18 18 18 18 18 18 18 18 18 18 18 18 18 18 18 18 18 18 18 18 18 18 18 18 18 18 18 18 18 18 18 18 18 18 18 18 18 18 19 18 18 18 18 18 18 18 18 18 18 18 18 18 18 18 18 18 18 18 18 18 18 18 18 18 
18 18 18 18 18 18 18 18 18 18 18 18 18 18 19 18 18 18 18 18 18 18 18 18 18 18 19 19 18 19 19 18 18 18 18 18 18 18 18 18 18 18 18 18 18 18 18 18 18 18 18 18 18 18 18 18 18 18 18 18 18 18 18 18 19 18 18 19 18 19 18 19 19 19 18 18 18 18 18 18 18 18 18 18 18 18 18 18 18 18 19 19 18 18 18 18 18 18 19 18 
19 18 18 18 18 18 18 18 18 18 18 18 18 18 18 18 18 18 18 19 19 19 18 18 19 19 18 18 18 18 18 18 18 18 18 18 18 18 18 18 18 18 18 18 19 19 19 18 18 18 18 18 18 18 18 18 18 18 18 18 18 18 18 18 18 18 18 18 18 18 18 18 18 18 18 18 18 18 18 18 18 18 19 18 18 18 18 18 18 18 18 18 19 18 19 18 18 18 18 18 
19 19 18 18 18 18 19 18 18 18 18 19 18 19 18 18 18 18 18 19 19 18 19 18 18 18 18 18 18 18 18 18 18 18 18 18 18 18 18 18 18 19 18 18 19 18 18 18 18 18 18 18 18 18 18 18 18 18 18 18 18 18 18 18 18 18 18 18 18 18 18 18 18 18 18 18 18 18 18 18 18 18 18 18 19 19 18 18 18 18 18 18 18 18 18 18 18 18 18 18 
18 19 18 18 18 18 18 18 18 18 18 18 18 18 18 18 18 18 18 18 18 18 18 18 18 18 18 18 18 18 18 18 19 18 19 19 19 18 18 18 18 18 19 18 18 18 18 18 18 18 18 18 18 18 18 18 18 18 18 18 18 18 18 18 18 18 18 18 18 19 19 18 18 18 18 18 18 18 18 18 19 18 18 18 18 18 19 19 18 18 18 18 18 18 18 18 18 18 18 18 
18 18 18 18 18 18 18 18 19 19 18 19 18 18 18 18 18 18 18 18 18 18 18 18 18 18 18 18 18 18 18 18 18 18 18 18 18 18 18 18 18 18 19 18 18 18 18 18 18 18 18 18 18 18 18 18 18 18 18 18 18 18 18 18 18 19 18 18 18 19 18 19 18 19 19 19 19 19 19 19 18 18 18 18 18 18 18 18 18 18 18 18 18 18 18 18 18 18 18 18 
18 18 18 18 18 18 18 19 18 18 18 18 19 18 18 18 18 18 18 18 18 18 18 18 18 18 18 18 18 18 18 18 18 18 18 18 18 18 18 18 18 18 18 18 18 19 18 18 18 18 18 18 18 18 18 18 18 18 19 18 18 18 18 18 18 18 18 18 18 18 18 18 18 18 18 19 18 19 18 18 18 18 18 18 18 18 18 18 18 18 18 18 18 18 18 18 18 18 18 18 
18 18 18 18 18 18 18 18 18 18 18 18 18 18 18 18 18 18 18 18 18 18 18 18 18 18 18 18 18 18 18 18 18 18 18 19 18 18 18 18 18 18 18 18 18 19 18 18 18 18 18 18 18 18 18 18 18 18 18 19 18 18 18 18 18 18 18 18 18 18 18 18 18 18 18 19 19 19 19 18 18 18 18 18 18 18 18 18 18 18 18 18 19 19 19 19 18 18 18 18 
18 18 18 18 18 18 18 18 18 18 18 18 18 28 26 26 26 26 26 26 26 26 26 26 26 26 26 26 26 26 26 26 26 26 26 26 26 26 26 26 26 26 26 26 26 26 26 26 26 26 26 26 26 26 29 18 18 18 18 18 18 18 18 18 18 18 18 18 18 18 18 18 18 18 18 18 18 18 19 19 18 19 19 18 18 18 18 18 18 18 18 18 18 18 18 18 19 18 18 18 
18 18 18 18 18 18 18 18 18 18 18 18 18 24 16 16 16 16 1 16 16 1 16 16 16 16 1 1 16 16 1 16 16 1 1 16 16 16 16 16 16 16 16 16 16 16 16 16 16 16 16 16 16 1 25 29 18 18 18 18 18 18 18 18 18 18 18 18 18 18 18 18 18 18 18 18 18 18 18 18 18 18 18 18 18 18 18 18 18 18 18 18 18 18 18 18 18 18 18 18 
18 18 18 18 18 19 18 18 18 18 18 18 18 24 16 16 16 16 16 16 16 16 16 16 16 16 16 16 16 16 16 16 16 16 16 16 16 16 16 16 16 16 16 16 16 16 16 16 16 1 16 16 16 16 16 23 18 19 19 19 18 18 18 18 18 18 18 18 18 18 18 18 18 18 18 18 18 18 18 18 18 18 18 18 18 18 18 18 18 18 18 18 18 18 18 18 18 18 18 18 
18 18 18 18 18 18 18 18 18 18 18 18 18 24 16 16 16 16 16 16 16 16 16 16 1 16 1 16 16 16 16 2 2 16 16 16 16 16 16 16 16 1 16 16 16 16 16 16 16 16 16 16 16 16 16 25 29 18 18 18 18 19 18 18 18 18 18 18 18 18 18 18 18 18 18 18 18 18 18 18 18 18 18 18 18 18 18 18 18 18 18 18 18 18 18 18 18 18 18 18 
18 18 18 18 18 18 18 18 19 19 18 18 18 24 16 16 16 16 1 16 16 16 16 16 16 16 1 16 16 16 16 12 10 10 10 10 10 10 13 16 16 16 1 16 16 16 16 16 16 16 16 16 16 16 16 16 25 29 18 18 18 18 19 19 18 18 18 18 18 18 18 18 18 18 18 18 18 18 18 18 18 18 18 18 18 18 18 18 18 18 18 18 18 18 18 18 18 18 18 18 
18 18 18 18 18 18 18 18 18 18 19 18 18 24 16 16 16 16 16 16 16 16 16 16 16 16 16 16 16 16 12 11 3 3 3 3 3 3 9 13 1 16 16 16 16 16 16 16 16 16 16 1 16 16 16 16 16 25 26 29 18 18 18 18 18 18 18 18 18 18 18 18 18 18 18 18 18 18 18 18 18 18 18 18 18 18 18 18 18 18 18 18 18 18 18 18 18 18 18 18 
18 18 18 18 18 18 18 18 18 18 18 18 18 24 16 16 16 16 16 16 16 16 16 16 16 16 16 16 16 12 11 3 3 3 3 3 3 3 3 9 13 16 1 16 16 16 1 16 1 16 16 16 16 16 16 16 16 16 16 25 29 18 18 18 18 18 18 18 18 18 18 18 18 18 18 18 18 18 18 18 18 18 18 18 18 18 18 18 18 18 18 18 18 18 18 18 18 18 18 18 
18 18 18 18 18 18 18 18 18 18 18 18 18 24 16 16 16 16 16 16 16 16 16 16 16 16 16 16 12 11 3 3 3 3 3 3 3 3 3 3 9 13 16 1 16 16 16 16 16 16 16 16 1 16 16 1 16 16 16 16 23 18 18 18 18 18 18 18 18 18 18 18 18 18 18 18 18 18 18 18 18 18 18 18 18 18 18 18 18 18 18 18 18 18 18 18 18 18 18 18 
18 18 18 18 18 18 18 18 18 18 18 18 18 24 16 16 16 16 16 16 16 1 16 16 16 16 16 16 8 3 3 3 3 3 3 3 3 3 3 3 3 7 16 1 16 1 16 16 16 16 16 16 16 16 16 16 16 16 16 16 23 18 18 18 18 18 18 18 18 18 18 18 18 18 18 18 18 18 18 18 18 18 18 18 18 18 18 18 18 18 18 18 18 18 18 18 18 18 18 18 
18 18 18 18 18 18 18 18 18 18 18 19 18 24 16 16 16 16 16 16 16 16 16 16 16 1 16 16 8 3 3 3 3 3 3 3 3 3 3 3 3 7 16 16 16 16 16 1 16 16 16 16 16 16 16 16 16 16 16 16 23 18 19 18 18 18 18 18 18 18 18 18 18 18 18 18 18 18 18 18 18 18 18 18 18 18 18 18 18 18 18 18 18 18 18 18 18 18 18 18 
18 18 18 18 18 18 18 18 18 18 18 18 18 24 16 16 16 16 16 16 16 16 1 16 16 1 16 1 8 3 3 3 3 3 3 3 3 3 3 3 3 7 1 16 16 16 16 16 16 16 16 2 16 1 16 16 16 16 16 16 23 18 18 18 18 18 19 18 18 18 18 18 18 18 18 18 18 18 18 18 18 18 18 18 18 18 18 18 18 18 18 18 18 18 18 18 18 18 18 18 
18 18 18 18 18 18 18 19 19 18 18 18 18 24 16 16 16 16 16 16 16 16 16 1 16 16 16 16 14 6 3 3 3 3 3 3 3 3 3 3 4 15 1 16 1 16 16 16 16 16 16 16 16 16 16 16 16 16 16 16 23 18 18 18 18 18 19 19 18 18 18 18 18 18 18 18 18 18 18 18 18 18 18 18 18 18 18 18 18 18 18 18 18 18 18 18 18 18 18 18 
18 18 18 18 18 19 18 18 18 18 18 18 18 24 1 16 16 16 16 16 16 16 16 16 16 16 16 16 2 14 6 3 3 3 3 3 3 3 3 4 15 16 16 16 1 16 2 16 16 16 16 16 16 16 16 16 16 16 16 16 23 18 19 18 18 18 18 19 18 18 18 18 18 18 18 18 18 18 18 18 18 18 18 18 18 18 18 18 18 18 18 18 18 18 18 18 18 18 18 18 
18 18 18 19 18 18 18 18 18 18 19 19 19 24 1 16 16 16 16 16 16 16 16 16 16 16 16 1 2 2 14 6 3 3 3 3 3 3 4 15 16 16 16 16 16 16 16 16 16 16 16 16 16 16 16 16 16 16 16 16 23 18 18 19 18 18 18 18 18 18 18 18 18 18 18 18 18 18 18 18 18 18 18 18 18 18 18 18 18 18 18 18 18 18 18 18 18 18 18 18 
18 18 19 18 18 18 18 18 18 18 19 18 18 24 1 1 16 16 16 16 16 16 16 16 16 16 1 1 1 1 1 14 5 6 3 3 4 5 15 1 16 16 16 16 1 16 16 16 16 16 16 16 16 16 16 16 16 16 16 16 25 29 18 18 18 18 18 19 19 19 19 18 18 18 18 18 18 18 18 18 18 18 18 18 18 18 18 18 18 18 18 18 18 18 18 18 18 18 18 18 
19 19 18 18 18 18 18 18 18 18 19 18 18 24 16 16 16 16 16 16 16 1 1 1 1 1 1 1 1 1 1 1 1 8 3 3 7 1 1 2 1 1 1 1 1 16 16 16 16 16 16 16 16 16 16 16 16 16 16 16 16 25 29 18 18 18 18 18 18 18 18 18 18 18 19 18 18 18 19 18 18 18 18 18 18 18 18 18 18 18 18 18 18 18 18 18 18 18 18 18 
19 19 18 18 18 18 18 18 18 18 19 18 18 24 16 16 16 16 16 16 16 16 16 16 1 1 1 1 2 1 1 1 1 8 3 3 7 1 1 1 1 2 1 1 1 16 16 16 16 16 16 16 16 16 16 16 16 16 16 16 16 16 25 29 18 18 18 18 18 18 18 18 18 18 18 18 18 18 18 18 18 18 18 18 18 18 18 18 18 18 18 18 18 18 18 18 18 18 18 18 
18 18 19 19 19 18 18 18 18 18 19 18 18 24 16 1 16 2 16 16 16 1 1 1 1 1 1 1 1 1 1 1 1 8 3 3 7 1 1 2 2 1 1 1 1 1 16 16 16 16 16 16 16 16 16 16 16 16 16 16 16 16 16 25 26 26 26 26 26 26 26 29 18 18 18 18 18 18 18 18 18 18 18 18 18 18 18 18 18 18 18 18 18 18 18 18 18 18 18 18 
18 18 18 18 18 19 18 18 18 19 19 18 18 24 16 16 16 16 16 16 12 10 10 10 10 10 10 10 10 10 10 10 10 11 3 3 9 10 10 10 10 10 10 10 10 13 16 16 16 16 16 16 16 16 16 16 16 16 16 16 16 16 16 1 1 1 1 1 1 1 1 25 26 26 26 26 29 18 18 18 18 18 18 18 18 18 18 18 18 18 18 18 18 18 18 18 18 18 18 18 
18 18 18 18 18 18 18 18 18 18 19 18 18 24 16 16 16 16 16 1 8 3 3 3 3 3 3 3 3 3 3 3 3 3 3 3 3 3 3 3 3 3 3 3 3 7 16 16 16 16 16 16 16 16 16 16 16 16 16 16 16 16 16 1 1 1 12 10 10 10 10 10 10 10 10 13 25 29 18 18 18 18 18 18 18 18 18 18 18 18 18 18 18 18 18 18 18 18 18 18 
18 18 18 18 18 18 18 18 18 18 18 19 18 24 16 16 16 2 16 1 14 5 5 5 5 5 5 5 5 5 5 5 5 5 5 5 5 5 5 5 5 5 5 6 3 7 16 16 16 16 16 16 16 16 16 16 16 16 16 16 16 16 16 1 1 1 8 3 3 3 3 3 3 3 3 7 1 23 18 18 18 18 18 18 18 18 18 18 18 18 18 18 18 18 18 18 18 18 18 18 
18 18 18 18 18 18 18 18 18 18 18 19 19 24 16 16 16 16 16 16 16 1 1 1 2 1 1 1 16 16 16 16 16 1 1 1 2 1 1 1 1 1 1 8 3 7 16 16 16 16 16 16 16 16 16 16 16 16 16 16 16 16 16 1 1 1 8 3 3 3 3 3 3 3 3 7 1 23 18 18 18 18 18 18 18 18 18 18 18 18 18 18 18 18 18 18 18 18 18 18 
18 18 18 18 18 18 18 18 18 18 18 18 18 24 1 16 16 16 16 16 16 16 16 1 16 16 16 16 16 16 16 16 16 16 16 16 16 1 1 1 1 1 1 8 3 7 16 16 16 16 16 16 16 16 16 16 16 16 16 16 16 16 16 1 1 1 14 6 3 3 3 3 3 3 3 7 1 23 18 18 18 18 18 18 18 18 18 18 18 18 18 18 18 18 18 18 18 18 18 18 
18 18 18 18 18 18 18 18 18 18 18 18 18 24 1 1 1 1 16 16 16 16 16 1 16 16 16 16 16 16 16 16 16 16 16 16 16 16 16 16 1 1 1 8 3 7 16 16 16 16 16 16 16 16 16 16 16 16 16 16 16 16 16 1 1 1 1 1 6 3 3 3 3 3 3 7 1 23 18 18 19 19 19 19 18 18 18 18 18 18 18 18 18 18 18 18 18 18 18 18 
18 18 18 18 18 18 18 18 18 18 18 18 18 30 22 1 1 1 1 16 16 16 16 2 1 1 2 1 1 16 16 16 16 16 16 16 16 16 16 16 16 16 16 8 3 7 16 16 16 16 16 16 16 16 16 16 16 16 16 16 16 16 16 1 1 1 1 1 11 3 3 3 3 3 3 7 1 23 18 18 18 18 18 18 18 18 18 18 18 19 19 18 18 18 18 18 18 18 18 18 
18 18 18 18 18 18 18 18 18 18 18 18 18 18 30 21 21 21 22 16 16 16 16 16 16 16 16 16 2 16 16 16 16 16 16 16 16 16 16 16 16 16 16 8 3 7 16 16 16 16 16 16 16 16 12 10 10 10 10 10 10 10 10 10 10 10 10 11 3 3 4 6 3 3 3 7 16 23 18 18 18 18 18 18 18 18 18 18 18 18 18 19 18 18 18 18 18 18 18 18 
18 18 18 18 18 18 18 18 18 18 18 18 18 18 18 18 18 18 24 16 16 16 16 16 16 16 16 16 1 1 1 1 16 16 16 16 16 16 16 16 16 16 16 8 3 7 16 16 16 16 16 16 16 16 8 3 3 3 3 3 3 3 3 3 3 3 3 3 3 4 15 14 5 5 5 15 16 23 18 18 18 18 18 18 18 18 18 18 18 18 18 19 18 18 18 18 18 18 18 18 
18 18 18 18 18 18 18 18 18 18 18 18 18 18 18 18 18 18 24 16 16 16 16 2 16 16 16 16 16 16 16 2 16 16 16 16 16 16 16 16 16 16 16 8 3 7 16 16 16 16 16 16 16 16 8 3 4 5 5 5 5 5 5 5 5 5 6 3 4 15 16 16 16 16 16 16 16 23 18 18 18 18 18 18 18 18 19 18 18 18 18 19 18 18 18 18 18 18 18 18 
18 18 18 18 18 18 18 18 18 18 18 18 18 18 18 18 18 18 24 16 16 16 16 16 16 16 16 16 16 12 10 10 10 10 10 10 10 10 10 10 10 13 1 8 3 7 16 16 16 16 16 16 16 16 8 3 7 16 16 16 16 16 16 16 16 16 8 3 7 16 16 16 16 16 16 16 16 23 18 18 18 18 18 18 18 18 19 18 18 18 18 18 18 18 18 18 18 18 18 18 
18 18 18 18 18 18 18 18 18 18 18 18 18 18 18 18 18 18 30 22 16 16 16 16 16 16 16 16 16 8 3 3 3 3 3 3 3 3 3 3 3 7 1 8 3 7 16 16 16 16 16 16 16 16 8 3 7 16 16 16 16 16 16 16 16 16 8 3 7 16 1 16 16 16 16 16 16 23 18 18 18 18 18 18 18 18 18 18 18 18 18 18 18 18 18 18 18 18 18 18 
18 18 18 18 18 18 18 18 18 18 18 18 18 18 18 18 18 18 18 30 21 21 21 21 21 21 21 21 22 8 3 3 3 3 3 3 3 3 3 3 3 9 10 11 3 9 10 10 10 10 10 10 10 10 11 3 7 16 16 1 16 16 16 16 16 16 8 3 7 16 16 16 16 16 16 16 16 23 18 18 18 18 18 18 18 18 18 19 19 18 18 18 18 19 18 18 18 18 18 18 
18 18 18 18 18 18 18 18 18 18 18 18 18 18 18 18 18 18 18 18 18 18 18 18 18 18 18 18 24 8 3 3 3 3 3 3 3 3 3 3 3 3 3 3 3 3 3 3 3 3 3 3 3 3 3 3 7 16 16 16 16 16 16 16 16 16 8 3 7 16 16 16 16 16 16 16 16 23 18 18 18 18 18 18 18 18 18 18 18 18 18 18 18 19 19 18 18 18 18 18 
18 18 18 18 18 18 18 18 18 18 18 18 18 18 18 18 18 18 18 18 18 18 19 19 18 18 19 18 24 14 6 3 3 3 3 3 3 3 3 3 3 4 5 5 5 5 5 6 3 4 5 5 5 5 5 5 15 16 16 16 16 16 16 16 16 16 8 3 7 16 16 32 32 32 32 32 32 23 19 18 18 18 18 18 18 18 18 18 18 18 18 18 18 18 19 18 18 18 18 18 
18 18 18 18 18 18 18 18 18 18 18 18 18 18 18 18 18 18 18 18 19 18 18 18 18 18 18 18 24 1 14 6 3 3 3 3 3 3 3 3 3 7 16 16 16 16 16 8 3 7 16 16 16 16 16 16 16 16 16 1 16 16 1 16 16 16 8 3 7 16 16 32 17 17 17 17 32 23 19 18 18 18 18 18 18 18 18 18 18 18 18 18 18 19 19 18 18 18 18 18 
18 18 18 18 18 18 18 18 18 18 18 18 18 18 18 18 18 18 18 18 18 18 18 18 18 18 18 18 30 22 1 14 6 3 3 3 3 3 3 3 3 7 16 16 2 16 16 8 3 7 16 16 16 16 16 16 16 16 16 16 16 16 16 16 16 16 8 3 9 10 10 32 17 17 17 17 32 23 18 18 18 18 18 18 18 18 18 18 18 18 18 18 18 19 18 18 18 18 18 18 
18 18 18 18 18 18 18 18 18 18 18 18 18 18 18 18 18 18 18 18 18 18 18 18 18 19 18 18 18 30 22 1 14 5 5 5 5 5 5 5 5 15 16 16 16 16 16 8 3 7 16 16 16 16 16 1 16 16 16 16 16 16 1 16 16 16 8 3 3 3 3 17 17 17 17 17 32 23 18 18 18 18 18 18 18 18 18 18 18 18 18 18 19 19 19 18 18 18 18 18 
18 18 18 18 18 18 18 18 18 18 18 18 18 18 18 18 18 18 18 18 18 18 18 18 18 18 18 19 18 18 30 21 21 21 21 21 21 21 22 16 16 16 16 2 16 16 16 8 3 7 16 16 16 16 16 16 16 16 16 16 16 16 16 16 16 16 8 3 4 5 5 32 17 17 17 17 32 23 18 18 19 18 18 18 18 18 18 18 18 18 18 18 19 18 19 18 18 18 18 18 
18 18 18 18 18 18 18 18 18 18 18 18 18 18 18 18 18 18 18 18 18 18 18 18 18 18 18 18 18 18 18 18 18 18 18 18 18 18 24 16 16 16 16 16 16 16 16 8 3 7 16 16 16 1 16 16 16 16 16 16 1 16 16 16 16 16 8 3 7 16 16 32 17 17 17 17 32 23 18 18 18 18 18 18 18 18 18 18 18 18 18 18 19 18 18 18 18 18 18 18 
18 18 18 18 18 18 18 18 18 18 19 18 18 18 18 18 18 18 18 18 18 18 18 18 18 18 18 18 18 18 18 18 18 18 19 18 18 18 24 16 16 16 16 16 16 16 16 8 3 7 16 16 16 16 16 16 16 16 16 16 16 16 16 16 16 16 8 3 7 16 16 32 17 17 17 17 32 23 18 18 18 18 18 18 18 18 18 18 18 18 18 18 19 18 18 18 18 18 18 18 
18 18 18 18 18 18 18 18 18 18 18 18 19 18 18 18 18 18 18 18 18 18 18 18 18 18 19 18 18 18 18 18 19 18 18 18 18 18 24 16 16 16 16 16 16 16 16 8 3 7 16 16 16 16 16 16 16 16 16 16 16 16 16 16 16 16 8 3 7 16 16 32 17 17 17 17 32 23 18 18 18 19 18 18 18 18 18 18 18 18 18 18 18 18 18 18 18 18 18 18 
18 18 18 18 18 18 18 18 18 18 18 18 18 18 18 18 18 18 18 18 18 18 18 18 19 19 18 19 18 18 18 18 18 18 18 18 18 18 24 16 16 16 16 16 16 16 16 8 3 7 1 1 1 1 1 1 1 1 1 1 1 1 1 1 1 1 8 3 7 16 16 32 17 17 17 36 32 23 18 18 18 18 19 18 18 18 18 18 18 18 18 18 18 18 18 18 18 18 18 18 
18 18 18 18 18 18 18 19 18 18 18 18 18 18 18 18 18 18 18 19 18 18 18 18 19 18 18 18 18 19 19 18 18 18 19 18 18 18 24 16 16 16 16 16 16 16 16 8 3 7 16 16 16 16 16 16 16 16 16 16 16 16 16 16 16 16 8 3 7 16 16 32 32 32 32 32 32 23 19 19 18 18 18 18 18 18 18 18 18 18 18 18 18 18 18 18 18 18 18 18 
18 18 18 18 18 18 18 19 18 18 18 18 18 18 18 18 18 18 18 18 18 18 19 19 18 18 18 18 19 19 18 18 18 18 18 18 18 18 24 16 16 2 16 16 16 16 16 8 3 7 16 16 16 16 16 16 16 16 16 16 16 16 16 16 16 16 8 3 7 16 16 16 16 16 16 16 16 23 18 18 18 18 18 18 18 18 18 18 18 18 18 18 18 18 18 18 18 18 18 18 
18 18 18 18 18 18 18 18 18 18 18 18 18 18 18 18 18 18 18 18 18 18 19 19 18 18 18 18 18 18 18 18 18 18 18 18 18 18 24 16 16 16 16 16 16 16 16 8 3 7 16 16 16 16 16 16 16 16 16 16 16 16 16 16 16 16 8 3 7 16 16 16 16 16 16 16 16 23 18 18 18 18 18 18 18 18 18 18 18 18 18 18 18 18 18 18 18 18 18 18 
18 18 18 18 18 18 18 19 18 18 18 18 18 18 18 18 18 18 18 18 18 18 18 18 18 18 19 18 18 18 18 18 18 18 18 18 18 18 24 16 16 16 16 16 16 16 16 8 3 7 16 16 16 16 16 16 2 16 16 16 16 2 16 16 16 16 8 3 7 16 16 16 16 16 16 16 16 23 18 18 18 18 18 18 18 18 18 18 18 18 18 18 18 18 18 18 18 18 18 18 
18 18 18 18 18 18 18 19 19 18 18 19 19 18 18 18 18 18 18 18 18 18 18 18 18 18 19 18 18 18 18 18 18 18 18 18 18 18 24 16 16 16 16 16 16 16 16 8 3 7 16 16 2 16 16 16 16 16 16 16 16 16 16 16 16 16 8 3 7 16 16 16 16 16 16 16 16 23 18 18 18 18 18 18 18 18 18 18 18 18 18 18 18 18 18 18 18 18 18 18 
18 18 18 19 18 18 18 18 18 18 18 18 18 18 19 18 18 18 18 18 18 18 18 18 18 18 19 18 18 18 18 18 18 18 18 18 18 18 24 16 16 16 16 16 16 16 16 8 3 7 16 16 2 16 16 16 16 16 16 16 16 16 16 16 16 16 8 3 7 16 16 16 16 2 16 16 16 23 19 18 18 18 18 18 18 18 18 18 18 18 18 18 18 18 18 18 18 18 18 18 
18 18 18 18 18 18 18 18 18 18 18 18 18 18 18 18 18 18 18 18 18 18 19 18 18 18 19 18 18 18 18 18 18 18 18 18 18 18 24 16 16 16 16 16 16 16 16 8 3 7 16 16 16 16 16 16 2 2 2 16 2 16 16 16 16 16 8 3 7 16 16 16 16 16 16 16 16 23 18 18 18 18 18 18 18 18 18 18 18 18 18 18 18 18 18 18 18 18 18 18 
18 18 18 18 18 18 18 18 18 18 18 18 18 18 18 18 18 18 18 28 26 26 26 26 26 26 26 26 26 26 26 26 26 26 26 26 26 26 27 16 16 16 16 16 16 16 16 8 3 7 16 16 16 16 16 16 16 16 16 16 2 16 16 16 16 16 8 3 7 16 16 16 16 16 16 16 16 23 18 19 18 18 18 18 18 18 18 18 18 18 18 18 18 18 18 18 18 18 18 18 
18 19 18 18 19 18 18 18 18 18 18 18 18 18 18 28 26 26 26 27 1 1 1 1 1 1 1 1 1 1 16 16 16 16 16 16 16 16 16 16 16 16 16 16 16 16 16 8 3 7 16 16 16 16 16 16 16 16 16 16 16 16 16 16 16 16 8 3 7 16 16 16 16 16 16 16 16 23 18 18 18 18 18 18 18 18 18 18 18 18 18 18 18 18 18 18 18 18 18 18 
18 18 18 18 18 18 18 18 18 19 18 18 18 18 28 27 1 1 1 1 1 1 1 1 1 1 16 16 16 16 16 16 16 16 16 16 16 16 16 16 16 16 16 16 16 16 16 8 3 7 16 16 16 16 16 16 16 16 16 16 16 16 16 16 16 16 8 3 7 16 16 16 16 16 1 1 16 23 18 18 19 18 18 18 18 18 18 18 18 18 18 18 18 18 18 18 18 18 18 18 
18 18 18 18 18 18 18 18 18 28 26 26 26 26 27 1 1 1 1 1 1 2 2 1 1 16 16 12 10 10 10 10 10 10 10 10 10 10 10 10 10 10 10 10 10 10 10 11 3 9 10 10 10 10 10 10 10 10 10 10 10 10 10 10 10 10 11 3 7 16 16 16 16 16 16 16 16 23 18 18 19 18 18 18 18 18 18 18 18 18 18 18 18 18 18 18 18 18 18 18 
18 18 18 18 18 18 18 18 28 27 1 1 1 1 1 1 2 1 1 1 2 2 16 16 16 16 12 11 3 3 3 3 3 3 3 3 3 3 3 3 3 3 3 3 3 3 3 3 3 3 3 3 3 3 3 3 3 3 3 3 3 3 3 3 3 3 3 3 7 16 16 16 16 16 16 16 16 23 18 18 18 18 18 18 18 18 18 18 18 18 18 18 18 18 18 18 18 18 18 18 
18 18 18 18 18 19 18 18 24 1 1 1 1 2 1 1 1 1 1 2 16 16 16 12 10 10 11 3 3 4 5 5 5 6 3 4 5 5 5 5 5 5 5 5 5 5 5 5 5 5 5 5 5 5 5 5 5 5 5 5 5 5 5 5 5 5 5 5 15 16 16 16 2 16 16 16 16 23 18 18 19 18 18 18 18 18 18 18 18 18 18 18 18 18 18 18 18 18 18 18 
18 18 18 19 18 18 18 18 24 1 1 1 1 1 1 2 1 1 16 16 16 12 10 11 3 3 3 3 4 15 16 16 16 8 3 7 16 16 16 16 16 16 16 16 16 16 16 16 16 16 16 16 16 16 16 1 16 16 16 16 16 16 16 16 16 16 16 16 16 16 16 16 16 16 16 16 16 23 18 18 18 18 18 18 18 18 18 18 18 18 18 18 18 18 18 18 18 18 18 18 
18 18 18 18 18 18 18 18 24 1 1 2 1 1 1 2 16 16 16 12 10 11 3 3 3 4 5 5 15 16 16 16 16 8 3 7 16 16 16 1 16 16 16 16 16 16 16 16 16 16 16 16 16 16 16 1 16 16 16 16 16 16 16 16 16 16 16 16 16 16 16 16 16 16 16 16 16 23 18 18 18 18 18 18 18 18 18 18 18 18 18 18 18 18 18 18 18 18 18 18 
18 19 18 18 18 18 18 18 24 1 1 2 1 16 16 16 16 1 10 11 3 3 3 4 5 15 16 16 16 16 16 16 16 8 3 7 16 16 16 16 16 16 16 16 16 2 16 16 16 16 16 1 16 16 16 1 16 16 16 16 16 16 1 16 16 16 2 16 16 16 16 16 16 16 16 16 16 23 18 19 18 18 18 18 18 18 18 18 18 18 18 18 18 18 18 18 18 18 18 18 
18 19 19 18 18 18 19 18 24 1 1 1 1 1 12 10 10 11 3 3 3 4 5 15 16 16 16 16 16 12 10 10 10 11 3 9 10 10 13 16 16 16 16 16 16 16 16 16 16 16 16 16 16 16 16 1 16 16 16 16 16 16 16 16 16 16 16 16 16 16 16 16 16 16 16 16 16 23 18 19 18 18 18 18 18 18 18 18 18 18 18 18 18 18 18 18 18 19 18 18 
18 18 18 18 18 19 18 18 24 1 1 1 1 1 8 3 3 3 3 4 5 15 16 16 16 16 12 10 10 11 3 3 3 3 3 3 3 3 9 10 10 1 16 16 16 16 16 16 2 16 16 16 16 16 16 1 16 16 16 16 16 16 16 16 16 16 16 16 16 16 16 16 16 16 16 16 16 23 18 19 18 18 18 18 18 18 18 18 18 18 18 18 18 18 18 18 18 18 18 18 
18 18 18 18 18 18 18 18 24 1 1 1 1 1 14 5 5 5 5 15 16 16 16 16 16 12 11 3 3 3 3 3 3 3 3 3 3 3 3 3 3 9 1 16 16 16 16 16 16 16 1 16 16 16 16 1 16 16 16 16 16 16 16 16 16 16 16 16 16 16 16 16 2 16 16 16 16 23 18 18 18 18 18 18 18 18 18 18 18 18 18 19 18 18 18 18 18 18 18 18 
18 18 18 18 18 18 19 18 24 16 16 16 16 16 16 16 16 16 16 16 16 16 16 16 16 8 3 3 3 3 3 3 3 3 3 3 3 3 3 3 3 3 7 16 16 1 16 16 16 2 16 16 1 16 16 1 1 1 1 1 1 1 1 1 1 1 1 1 1 16 16 16 16 16 16 16 16 23 18 18 18 18 18 18 18 18 18 18 18 18 18 18 18 18 18 18 18 18 18 18 
18 18 18 18 18 18 18 18 24 16 16 16 16 16 16 16 16 16 16 16 16 16 16 16 16 8 3 3 3 3 3 3 3 3 3 3 3 3 3 3 3 3 7 16 16 16 16 16 16 16 16 16 16 16 16 16 16 16 16 16 16 16 16 16 16 16 16 16 1 16 16 16 16 16 16 16 16 23 18 19 18 18 18 18 18 18 18 18 18 18 18 18 18 18 18 18 18 18 18 18 
18 18 18 18 18 18 18 18 24 16 16 16 2 16 16 16 1 16 16 16 16 16 16 16 16 8 3 3 3 3 3 3 3 3 3 3 3 3 3 3 3 3 7 16 16 16 16 2 16 16 16 16 16 16 16 16 16 16 16 16 20 21 21 22 1 1 1 16 1 16 16 16 16 16 16 16 16 23 18 19 18 18 18 18 18 18 18 18 18 18 18 18 18 18 18 18 18 18 18 18 
18 18 18 18 18 18 19 18 24 16 16 16 16 16 1 16 16 16 16 16 16 16 16 16 16 8 3 3 3 3 3 3 3 3 3 3 3 3 3 3 3 3 7 16 16 16 16 16 16 16 16 16 16 16 16 2 16 16 16 16 23 18 18 24 1 33 1 1 1 16 16 16 16 16 16 16 16 23 18 18 18 18 18 18 18 18 18 18 18 19 18 18 18 18 18 18 18 18 18 18 
18 18 18 18 18 18 18 18 24 16 16 16 16 16 16 16 16 16 16 2 16 16 16 16 16 14 6 3 3 3 3 3 3 3 3 3 3 3 3 3 3 4 15 16 16 16 16 16 16 16 16 2 2 16 16 16 16 16 16 16 23 18 18 24 1 1 1 16 16 16 16 16 16 16 16 1 16 23 18 18 19 18 18 18 18 18 18 18 19 19 18 18 18 18 18 18 18 18 18 18 
18 19 19 18 18 18 18 18 24 16 16 16 2 16 16 16 2 16 16 16 16 16 1 16 16 16 14 5 5 6 3 3 3 3 3 3 3 3 4 5 5 15 16 16 2 16 16 16 16 1 16 16 16 16 16 16 16 16 16 16 25 26 26 27 16 16 16 16 2 16 16 16 16 16 16 16 16 23 18 18 18 18 18 18 18 18 18 18 18 18 18 18 18 18 18 18 18 18 18 18 
18 19 19 18 18 18 18 18 24 16 16 16 16 2 16 16 16 16 16 16 16 16 16 16 16 16 16 16 16 14 5 5 5 5 5 5 5 5 15 16 16 16 16 16 16 16 16 1 16 16 16 16 16 1 16 16 16 16 16 16 16 16 16 16 16 16 16 16 16 16 16 16 16 16 16 16 16 23 18 18 18 18 18 18 18 18 18 18 18 18 18 18 18 18 18 18 18 18 18 18 
18 18 19 19 18 18 18 18 30 22 16 16 16 16 16 16 16 16 16 16 16 16 16 16 16 16 16 16 16 16 16 16 16 16 16 16 16 16 16 16 16 16 16 16 16 16 16 16 16 16 16 16 16 16 16 16 16 16 16 16 16 16 16 16 16 16 16 16 16 16 16 16 16 16 16 16 20 31 18 18 18 18 18 18 18 18 18 18 18 18 18 18 18 18 18 18 18 18 18 18 
18 18 18 18 18 18 18 18 18 30 21 21 21 21 21 21 21 21 21 21 21 21 21 21 21 21 21 21 21 21 21 21 21 21 21 21 21 21 21 21 21 21 21 21 21 21 21 21 21 21 21 21 21 21 21 21 21 21 21 21 21 21 21 21 21 21 21 21 21 21 21 21 21 21 21 21 31 18 18 18 18 18 18 18 18 18 18 18 18 18 18 18 18 18 18 18 18 18 18 18 
18 18 18 18 18 18 18 18 18 18 18 18 18 18 18 18 18 18 18 18 18 19 18 18 18 18 18 18 18 18 18 18 18 18 18 18 19 19 18 18 18 18 18 18 18 18 18 18 18 18 18 18 18 18 18 18 18 18 18 18 18 18 18 18 18 18 18 18 18 18 18 18 18 18 18 18 18 18 18 18 18 18 18 18 18 18 18 18 18 18 18 18 18 18 18 18 18 18 18 18 
18 18 18 18 19 19 19 19 19 18 18 19 18 18 18 18 18 18 18 19 18 18 18 18 18 18 19 19 19 18 18 18 18 18 18 18 18 18 18 18 18 18 18 18 18 18 18 18 18 18 18 18 18 18 18 18 18 18 18 18 18 18 18 18 18 18 18 19 19 18 18 18 18 18 18 18 18 18 18 18 18 18 18 18 18 18 18 18 18 18 18 18 18 18 18 18 18 18 18 18 
18 19 18 19 19 18 19 19 19 19 18 19 18 18 18 18 18 18 18 19 18 18 18 18 18 18 18 18 18 19 18 18 18 18 18 18 18 18 18 18 18 18 18 18 18 18 18 18 18 18 18 18 18 18 18 19 18 18 19 19 19 19 19 18 18 18 18 18 18 18 18 18 18 19 18 18 18 18 18 18 18 18 18 18 18 18 18 18 18 18 18 18 18 18 18 18 18 18 18 18 
18 19 19 18 18 19 18 18 18 19 18 18 19 18 18 18 18 18 18 18 18 18 18 18 18 18 18 18 18 18 18 18 18 18 19 19 18 18 18 18 18 19 18 18 18 19 18 18 18 18 19 18 18 18 18 18 18 18 18 18 18 18 18 18 18 18 18 18 18 18 18 18 18 18 18 18 18 18 19 19 18 19 18 18 18 18 18 18 18 18 18 18 18 18 18 18 18 18 18 18 
19 18 18 18 18 19 18 18 18 18 18 18 18 18 18 18 18 18 18 18 18 18 18 18 18 18 18 18 18 18 18 18 18 18 18 18 18 18 18 18 18 18 18 18 18 18 18 18 18 18 18 18 18 18 18 18 18 18 18 18 18 18 18 18 18 18 18 19 18 18 18 18 18 18 18 18 18 18 19 18 18 19 18 18 18 18 18 18 18 18 18 18 18 18 18 18 18 18 18 18 
19 18 18 18 19 19 19 18 18 18 18 18 18 18 18 18 18 18 18 18 18 19 18 18 18 18 18 18 18 18 18 18 18 18 18 18 18 18 18 18 18 18 18 18 18 18 18 18 18 18 18 18 18 18 18 18 18 18 18 19 18 18 18 19 18 18 18 18 18 18 18 18 18 19 18 18 18 18 18 18 19 18 18 18 18 18 18 18 18 18 18 18 18 18 18 18 18 18 18 18 
19 18 18 19 19 18 18 18 18 18 18 18 18 18 18 18 18 18 18 18 18 18 19 19 18 18 18 18 18 18 18 18 18 18 18 18 18 18 18 18 18 18 18 18 18 18 18 18 18 18 18 18 18 18 18 18 18 19 18 18 18 18 18 19 18 18 18 18 18 18 18 18 18 19 18 18 18 18 18 18 19 18 18 18 18 18 18 18 18 18 18 18 18 18 18 18 18 18 18 18 
18 18 18 19 18 18 18 18 18 18 18 18 18 18 18 18 18 18 18 18 18 18 18 19 18 19 18 18 18 18 18 18 18 18 18 18 18 18 18 18 18 19 18 18 18 18 18 18 18 19 18 18 18 18 18 18 18 19 18 18 18 18 18 18 18 18 18 18 18 18 18 18 18 19 18 18 18 18 18 19 18 18 18 18 18 18 18 18 18 18 18 18 18 18 18 18 18 19 18 18 
18 19 19 18 18 18 18 18 18 18 18 18 18 18 18 18 18 18 18 18 18 18 18 18 18 18 19 18 18 18 18 18 18 18 18 18 18 18 18 19 18 18 18 18 18 18 18 18 18 18 18 18 18 18 18 18 18 18 18 18 18 18 18 18 18 18 18 18 18 18 18 18 18 18 18 18 18 18 18 18 18 18 18 18 18 18 18 18 18 18 18 18 18 18 18 18 18 19 18 18 
18 18 18 18 18 18 18 18 18 19 18 18 18 18 18 18 18 18 18 18 18 18 18 18 18 18 18 18 18 18 18 18 18 18 19 18 18 19 18 18 18 18 18 18 18 18 18 18 18 18 18 18 18 18 18 18 18 18 18 18 18 18 18 18 18 18 18 18 18 18 18 18 18 18 18 18 18 18 18 18 18 18 18 18 18 18 18 18 18 18 18 18 18 18 18 18 18 18 18 18 
18 18 19 18 18 18 18 18 18 19 18 18 18 18 18 18 18 18 18 18 18 18 18 18 18 18 18 18 18 18 19 18 18 19 18 18 18 18 19 19 18 18 18 18 18 18 18 18 18 18 18 18 18 18 18 18 18 18 18 18 18 18 18 18 18 18 18 18 18 18 18 18 18 18 18 18 18 18 18 18 18 18 18 18 18 18 18 18 18 18 18 18 18 18 18 18 18 18 18 18 
18 18 19 18 18 18 18 18 18 18 18 18 18 18 18 18 18 18 18 18 18 18 18 18 18 18 18 18 18 18 18 18 18 18 18 18 18 18 18 19 18 18 18 18 18 18 18 18 18 18 18 18 18 18 18 18 18 18 18 18 18 18 18 18 18 18 18 18 18 18 18 18 18 18 18 18 18 18 18 18 18 18 18 18 18 18 18 18 18 18 18 18 18 18 18 18 18 18 18 18 
18 18 19 18 18 18 18 18 18 19 19 19 19 18 18 18 18 18 18 18 18 18 19 19 18 18 18 18 18 18 18 18 18 18 18 18 18 18 18 18 18 18 18 18 18 18 18 18 18 18 18 18 18 18 18 18 18 18 19 18 18 18 18 18 18 18 19 18 18 18 18 18 18 18 18 18 18 18 18 18 18 18 18 18 18 18 18 18 18 18 18 18 18 18 18 18 19 18 18 18 
18 18 19 18 18 18 18 18 18 19 18 19 19 18 18 18 19 18 18 18 18 18 18 18 18 18 18 18 18 18 19 18 18 18 19 19 18 18 18 19 18 18 18 18 18 18 18 18 18 18 19 18 18 18 18 18 18 18 18 18 18 18 18 19 18 19 18 18 18 19 18 18 18 18 18 18 18 18 18 18 18 18 18 18 18 18 18 18 18 18 18 18 18 18 18 18 19 18 18 18 
18 18 18 19 18 18 18 18 18 19 19 18 18 18 18 18 18 18 18 18 18 18 19 19 18 18 19 18 18 18 18 18 18 18 18 18 18 18 19 19 18 18 18 18 18 18 18 18 18 18 18 18 19 18 18 18 18 18 18 18 18 18 18 19 19 19 18 18 18 19 18 18 18 18 18 18 18 18 18 18 18 18 18 18 18 18 18 18 18 18 18 18 18 18 18 19 18 18 18 18 
18 18 18 18 19 18 18 18 19 19 19 18 18 18 18 18 18 19 18 18 18 18 18 19 19 18 18 18 18 19 18 18 18 18 18 18 18 18 18 18 19 18 18 18 18 18 18 18 18 18 18 18 19 18 18 18 18 18 18 18 18 18 18 18 19 18 18 18 18 18 18 18 18 18 18 18 19 18 18 18 18 18 18 18 18 18 18 18 18 18 18 18 18 18 18 18 18 18 18 18 
18 18 18 18 18 19 19 19 19 19 19 19 19 18 18 18 18 18 18 18 18 19 18 18 18 18 18 18 18 19 18 18 18 18 18 18 18 19 19 19 18 18 18 18 18 18 18 18 18 18 18 18 18 18 18 18 18 18 18 18 18 18 18 18 18 18 18 18 18 18 18 18 18 18 18 19 18 18 18 18 18 18 18 18 18 18 18 18 18 18 18 18 18 18 18 18 18 18 18 18 
18 18 18 18 18 18 18 18 18 18 18 19 19 18 18 18 18 18 18 18 18 19 18 19 18 18 18 18 18 19 19 18 18 18 18 18 18 18 18 18 18 18 18 18 18 18 18 18 18 18 19 19 18 18 18 18 18 18 18 18 18 18 18 18 18 18 18 18 18 18 18 18 18 18 18 18 18 18 18 18 18 18 18 18 18 18 18 19 18 18 18 18 18 19 18 18 18 18 18 18 
18 18 18 18 18 18 18 18 18 18 18 18 18 18 18 18 18 18 18 18 18 18 18 18 18 18 18 18 19 18 18 18 18 18 18 18 18 18 18 18 18 18 18 18 18 18 18 18 18 18 18 19 19 18 18 18 18 18 18 19 18 18 18 18 18 18 18 18 18 18 18 19 18 18 18 18 18 18 18 18 18 18 18 18 18 18 18 18 18 18 18 18 18 18 18 18 18 18 18 18 
18 18 18 18 18 18 18 19 19 18 18 18 18 18 18 18 18 18 18 18 18 18 18 18 18 18 18 18 19 18 18 18 18 18 18 18 18 18 18 18 18 18 18 18 18 18 18 18 18 18 18 18 18 18 18 18 18 18 18 18 18 18 18 18 18 18 18 18 18 18 18 18 18 19 18 18 18 18 18 18 18 18 18 18 18 18 18 18 18 18 18 18 18 18 18 18 18 18 18 18 
18 18 18 18 18 18 18 18 18 18 18 18 18 18 18 18 18 18 19 18 18 18 18 18 18 18 18 18 18 18 18 18 18 18 18 18 18 18 19 18 18 18 18 18 18 18 18 18 18 18 18 18 18 18 18 18 18 18 18 18 18 18 18 18 18 18 18 18 18 18 18 18 18 18 18 18 18 18 18 18 18 18 18 18 18 18 18 18 18 18 19 19 18 18 18 18 18 18 18 18 
18 18 18 18 18 18 18 18 18 18 18 18 18 18 18 18 18 18 18 18 18 18 18 18 18 18 18 18 18 18 18 18 18 18 18 18 18 18 18 18 18 18 18 18 18 18 18 18 18 18 18 18 18 18 18 18 18 18 18 18 18 18 18 18 18 18 18 18 18 18 18 18 18 18 18 18 18 18 18 18 18 18 18 18 18 18 18 18 19 19 19 18 18 18 18 18 18 18 18 18 
