4 4 4 4 4 4 4 4 4 4 4 4 4 4 4 4 4 4 4 4 4 4 4 4 4 4 4 4 4 4 4 4 4 4 4 4 4 4 4 4 4 4 4 4 4 4 4 4 4 4 
4 4 4 4 4 4 4 4 4 4 4 4 4 4 4 4 4 4 4 4 4 4 4 4 4 4 4 4 4 4 4 4 4 4 4 4 4 4 4 4 4 4 4 4 4 4 4 4 4 4 
4 4 4 4 4 4 4 4 4 4 4 4 4 4 4 4 4 4 4 4 21 2 2 2 2 2 21 4 4 4 4 4 4 4 4 4 4 4 4 4 4 4 4 4 4 4 4 4 4 4
4 4 4 4 4 4 4 4 4 4 4 4 4 4 4 4 4 4 4 4 2 2 2 2 2 2 2 4 4 4 4 4 4 4 4 4 4 4 4 4 4 4 4 4 4 4 4 4 4 4 
4 4 4 4 4 4 4 4 4 4 4 4 4 4 4 4 4 4 4 4 2 2 2 2 2 2 2 4 4 4 4 4 4 4 4 4 4 4 4 4 4 4 4 4 4 4 4 4 4 4 
4 4 4 4 4 4 4 4 4 4 4 4 4 4 4 4 4 4 4 4 2 2 2 2 2 2 2 4 4 4 4 4 4 4 4 4 4 4 4 4 4 4 4 4 4 4 4 4 4 4 
4 4 4 4 4 4 4 4 1 1 1 1 1 4 4 4 4 4 4 4 4 2 2 2 2 2 4 4 4 4 4 4 4 4 4 4 4 4 4 4 4 4 4 4 4 4 4 4 4 4 
4 4 4 4 4 4 4 4 1 3 3 3 1 4 4 4 4 4 4 4 21 21 21 21 21 21 21 4 4 4 4 4 4 21 6 6 6 6 6 6 6 4 4 4 4 4 4 4 4 4
4 4 4 4 4 4 4 4 1 3 3 3 1 4 4 4 4 4 4 4 4 21 21 21 21 21 4 4 4 4 4 4 4 4 6 6 6 6 6 6 6 6 4 4 4 4 4 4 4 4
4 4 4 4 4 4 4 4 1 3 3 3 1 4 4 4 4 4 4 4 4 4 21 21 21 4 4 4 4 4 4 4 4 4 6 6 6 6 6 6 6 6 4 4 4 4 4 4 4 4
4 4 4 4 4 4 4 4 1 3 3 3 1 4 4 4 4 4 4 4 4 4 4 6 4 4 4 4 4 4 4 4 4 4 6 6 6 6 6 6 6 6 4 4 4 4 4 4 4 4
4 4 4 4 4 4 4 4 1 1 21 1 1 4 4 4 4 4 4 4 4 4 4 6 4 4 4 4 4 4 4 4 4 4 6 6 6 6 6 6 6 6 4 4 4 4 4 4 4 4
4 4 4 4 4 4 4 4 4 4 21 4 4 4 4 4 4 4 4 4 4 4 4 6 4 4 4 4 4 4 4 4 4 4 4 6 6 6 6 6 6 4 4 4 4 4 4 4 4 4
4 4 4 4 4 4 4 4 4 4 21 4 4 4 4 4 4 4 4 4 4 4 4 6 4 4 4 4 4 4 4 4 4 4 4 4 4 4 6 4 4 4 4 4 4 4 4 4 4 4
4 4 4 4 4 4 4 4 4 4 21 4 4 4 4 4 4 4 4 4 4 4 4 6 4 4 4 4 4 4 4 4 4 4 4 4 4 4 6 4 4 4 4 4 4 4 4 4 4 4
4 4 4 4 4 4 4 4 4 4 21 4 4 4 4 4 4 4 4 4 4 4 4 6 4 4 4 4 4 4 4 4 4 4 4 4 4 4 6 4 4 4 4 4 4 4 4 4 4 4
4 4 4 4 4 4 4 4 21 21 21 4 4 4 4 4 4 4 4 4 4 4 4 6 4 4 4 4 4 4 4 4 4 4 4 4 4 4 6 4 4 4 4 4 4 4 4 4 4 4
4 4 4 4 4 4 4 4 21 4 4 4 4 4 4 4 4 4 4 4 4 4 4 6 4 4 4 4 4 4 4 4 4 4 4 4 4 4 6 4 4 4 4 4 4 4 4 4 4 4
4 4 4 4 4 4 4 4 21 4 4 4 4 4 4 4 4 4 4 4 4 4 21 6 23 4 4 4 4 4 4 4 4 4 4 4 6 6 6 4 4 4 4 4 4 4 4 4 4 4
4 4 4 4 4 4 4 4 21 4 4 4 4 4 4 4 4 4 4 4 4 23 21 6 21 21 4 4 4 4 4 4 4 4 4 4 6 4 4 4 4 4 4 4 4 4 4 4 4 4
4 4 4 4 4 4 4 4 21 4 4 4 4 4 4 4 4 4 4 4 23 21 21 6 23 21 21 4 4 4 4 4 4 4 4 6 6 4 4 4 4 4 4 4 4 4 4 4 4 4
4 4 4 4 4 4 4 4 21 4 4 4 6 6 6 6 6 6 6 6 6 6 6 6 6 6 6 6 6 6 6 6 6 6 6 6 6 4 4 4 4 4 4 4 4 4 4 4 4 4
4 4 4 4 4 4 4 4 21 4 4 4 21 4 4 4 4 4 4 4 21 23 21 6 21 21 21 4 4 4 4 4 4 4 4 4 6 4 4 4 4 4 4 4 4 4 4 4 4 4
4 4 4 4 4 4 4 4 21 4 4 4 21 4 4 4 4 4 4 4 4 21 23 6 23 21 4 4 4 4 4 4 4 4 4 4 6 4 4 4 4 4 4 4 4 4 4 4 4 4
4 4 4 4 4 4 4 4 21 4 4 4 21 4 4 4 4 4 4 4 4 4 21 6 21 4 4 4 4 4 4 4 4 4 4 4 6 4 4 4 4 4 4 4 4 4 4 4 4 4
4 4 4 4 4 4 4 4 21 4 4 4 21 21 21 4 4 4 4 4 4 4 4 6 4 4 4 4 4 4 4 4 4 4 4 4 6 4 4 4 4 4 4 4 4 4 4 4 4 4
4 4 4 4 4 4 4 4 21 4 4 4 4 4 21 4 4 4 4 4 4 4 4 6 4 4 4 4 4 4 4 4 4 4 4 4 6 4 4 4 4 4 4 4 4 4 4 4 4 4
4 4 4 4 4 4 4 4 21 4 4 4 4 4 21 4 4 4 4 4 4 4 4 6 4 4 4 21 4 4 4 4 4 4 4 21 6 4 4 4 4 4 4 4 4 4 4 4 4 4
4 4 4 4 4 4 4 4 21 4 4 4 4 4 21 4 4 4 4 4 4 4 4 6 4 4 4 4 4 4 21 4 4 4 4 4 6 4 4 4 4 4 4 4 4 4 4 4 4 4
4 4 4 4 4 4 4 4 21 21 21 21 23 21 21 4 4 4 4 4 4 4 4 6 4 4 4 4 4 4 21 4 4 4 4 4 6 4 4 4 4 4 4 4 4 4 4 4 4 4
4 4 4 4 4 4 4 4 21 23 21 21 21 21 21 4 4 4 4 4 4 4 4 6 4 4 4 4 4 4 4 4 4 4 4 4 21 4 4 4 4 4 4 4 4 4 4 4 4 4
4 4 4 4 4 4 4 4 21 21 21 21 23 21 21 4 4 4 4 4 4 4 4 6 4 4 4 4 4 4 4 4 4 4 4 21 21 21 4 4 4 4 4 4 4 4 4 4 4 4
4 4 4 4 4 4 4 4 21 21 23 21 21 21 21 4 4 4 4 4 4 4 4 6 4 4 4 4 4 4 4 4 4 4 4 23 21 23 4 4 4 4 4 4 4 4 4 4 4 4
4 4 4 4 4 4 4 4 21 21 21 21 21 21 21 4 4 4 4 4 4 4 4 6 4 4 4 4 4 4 4 4 4 4 4 21 21 21 4 4 4 4 4 4 4 4 4 4 4 4
4 4 4 4 4 4 4 4 21 21 21 21 23 21 21 4 4 4 4 4 4 4 4 6 4 4 4 4 4 4 4 4 4 4 4 21 23 21 4 4 4 4 4 4 4 4 4 4 4 4
4 4 4 4 4 4 4 4 4 4 4 4 4 4 4 4 4 4 4 4 4 4 4 6 4 4 4 4 4 4 4 4 4 4 4 21 21 21 4 4 4 4 4 4 4 4 4 4 4 4
4 4 4 4 4 4 4 4 4 4 4 4 4 4 4 4 4 4 4 21 23 21 21 23 21 21 21 4 4 4 4 4 4 4 21 21 21 21 21 4 4 4 4 4 4 4 4 4 4 4
4 4 4 4 4 4 4 4 4 4 4 4 4 4 4 4 4 4 21 21 21 21 21 21 21 21 21 21 4 4 21 4 4 21 23 21 21 23 21 4 4 4 4 4 4 4 4 4 4 4
4 4 4 4 4 4 4 4 4 4 4 4 4 4 4 4 4 4 21 21 23 21 21 23 21 23 21 21 4 4 4 4 21 21 21 23 21 21 21 4 4 4 4 4 4 4 4 4 4 4
4 4 4 4 4 4 4 4 4 4 4 4 4 21 4 4 4 4 21 21 21 21 23 21 21 21 21 21 21 4 4 4 21 21 21 21 21 4 21 4 4 4 4 4 4 4 4 4 4 4
4 4 4 4 4 4 4 4 4 4 4 4 4 4 4 4 4 4 21 23 21 21 23 21 21 23 21 21 21 21 23 21 23 21 4 21 23 21 21 4 4 4 4 4 4 4 4 4 4 4
4 4 4 4 4 4 4 4 4 4 4 4 4 21 4 4 4 4 4 21 21 21 23 21 21 21 21 4 4 4 4 21 21 21 21 23 21 21 21 4 4 4 4 4 4 4 4 4 4 4
4 4 4 4 4 4 4 4 4 4 4 4 4 4 4 4 4 4 4 4 21 21 21 21 21 21 4 4 4 4 4 21 23 4 21 23 4 23 21 4 4 4 4 4 4 4 4 4 4 4
4 4 4 4 4 4 4 4 4 4 4 4 4 4 4 4 4 4 4 4 4 4 4 4 4 4 4 4 4 4 4 4 21 21 21 23 21 21 4 4 4 4 4 4 4 4 4 4 4 4
4 4 4 4 4 4 4 4 4 4 4 4 4 4 4 4 4 4 4 4 4 4 4 4 4 4 4 4 4 4 4 4 4 4 4 4 4 4 4 4 4 4 4 4 4 4 4 4 4 4 
4 4 4 4 4 4 4 4 4 4 4 4 4 4 4 4 4 4 4 4 4 4 4 4 4 4 4 4 4 4 4 4 4 4 4 4 4 4 4 4 4 4 4 4 4 4 4 4 4 4 
4 4 4 4 4 4 4 4 4 4 4 4 4 4 4 4 4 4 4 4 4 4 4 4 4 4 4 4 4 4 4 4 4 4 4 4 4 4 4 4 4 4 4 4 4 4 4 4 4 4 
4 4 4 4 4 4 4 4 4 4 4 4 4 4 4 4 4 4 4 4 4 4 4 4 4 4 4 4 4 4 4 4 4 4 4 4 4 4 4 4 4 4 4 4 4 4 4 4 4 4 
4 4 4 4 4 4 4 4 4 4 4 4 4 4 4 4 4 4 4 4 4 4 4 4 4 4 4 4 4 4 4 4 4 4 4 4 4 4 4 4 4 4 4 4 4 4 4 4 4 4 
4 4 4 4 4 4 4 4 4 4 4 4 4 4 4 4 4 4 4 4 4 4 4 4 4 4 4 4 4 4 4 4 4 4 4 4 4 4 4 4 4 4 4 4 4 4 4 4 4 4 